5   1   1.0 1.0 0.2 2.0 10.0    0.5 200 300.0
0   3   6   6   2
3   0   3   2   5
6   3   0   0   0
6   2   0   0   1
2   5   0   1   0